a la derecha de = to the right of
a la izquierda de = to the left of
la administración de empresas = business administration
¿Adónde? = Where (to)?
ahora = now
al lado de = next to
allá = over there
allí = there
la arqueología = archeology
el arte = art
bailar = to dance
la biblioteca = library
la biología = biology
el borrador = eraser
buscar = to look for
la cafetería = cafeteria
la calculadora = calculator
caminar = to walk
cantar = to sing
la casa = house; home
cenar = to have dinner
cerca de = near
las ciencias = sciences
la clase = class
el/la compañero/a de clase = classmate
el/la compañero/a de cuarto = roommate
comprar = to buy
la computación = computer science
con = with
la contabilidad = accounting
contestar = to answer
conversar = to converse, to chat
¿Cuál?, ¿Cuáles? = Which?; Which one(s)?
¿Cuándo? = When?
el curso, la materia = course
debajo de = below
delante de = in front of
desayunar = to have breakfast
descansar = to rest
desear = to wish; to desire
detrás de = behind
dibujar = to draw
domingo = Sunday
la economía = economics
en = in; on
encima de = on top of
enseñar = to teach
entre = between
el escritorio = desk
escuchar la radio/música = to listen (to) the radio/music
el español = Spanish
la especialización = major
esperar (+ inf.) = to wait (for); to hope
el estadio = stadium
estar = to be
el/la estudiante = student
estudiar = to study
el examen = test; exam
explicar = to explain
la física = physics
la geografía = geography
gustar = to like
hablar = to talk; to speak
la historia = history
el horario = schedule
Hoy es… = Today is…
las humanidades = humanities
el inglés = English
jueves = Thursday
el laboratorio = laboratory
lejos de = far from
las lenguas extranjeras = foreign languages
la librería = bookstore
el libro = book
la literatura = literature
llegar = to arrive
llevar = to carry
lunes = Monday
el mapa = map
martes = Tuesday
las matemáticas = mathematics
la mesa = table
miércoles = Wednesday
mirar = to look (at); to watch
la mochila = backpack
la música = music
necesitar (+ inf.) = to need
el papel = paper
la papelera = wastebasket
el periodismo = journalism
la pizarra = blackboard
la pluma = pen
¿Por qué? = Why?
porque = because
practicar = to practice
preguntar = to ask (a question)
preparar = to prepare
el/la profesor(a) = teacher
la prueba = test; quiz
la psicología = psychology
la puerta = door
¿Qué día es hoy? = What day is it?
la química = chemistry
regresar = to return
el reloj = clock; watch
la residencia estudiantil = dormitory
sábado = Saturday
la semana = week
el semestre = semester
la silla = chair
sin = without
sobre = on; over
la sociología = sociology
la tarea = homework
terminar = to end; to finish
la tiza = chalk
tomar = to take; to drink
trabajar = to work
el trimestre = trimester; quarter
la universidad = university; college
la ventana = window
viajar = to travel
viernes = Friday 
