almorzar (o:ue) = to have lunch
andar en patineta = to skateboard
el baloncesto = basketball
el béisbol = baseball
bucear = to scuba dive
el café = café
el centro = downtown
cerrar (e:ie) = to close
el ciclismo = cycling
el cine = movie theater
comenzar (e:ie) = to begin
conseguir (e:i) = to get; to obtain
contar (o:ue) = to count; to tell
decir (e:i) = to say; to tell
deportivo/a = sports-related
la diversión = fun activity; entertainment; recreation
dormir (o:ue) = to sleep
empezar (e:ie) = to begin
encontrar (o:ue) = to find
entender (e:ie) = to understand
el equipo = team
escalar montañas (f., pl.) = to climb mountains
escribir un mensaje electrónico = to write an e-mail
escribir una carta = to write a letter
el esquí (acuático) = (water) skiing
esquiar = to ski
favorito/a = favorite
el fin de semana = weekend
el fútbol = soccer
el fútbol americano = football
ganar = to win
el gimnasio = gymnasium
el golf = golf
hacer = to do; to make
el hockey = hockey
la iglesia = church
ir = to go
ir de excursión = to go on a hike
el/la jugador(a) = player
jugar (u:ue) = to play (a sport or a game)
leer el correo electrónico = to read e-mail
leer un periódico = to read a newspaper
leer una revista = to read a magazine
el lugar = place
mostrar (o:ue) = to show
el museo = museum
nadar = to swim
la natación = swimming
oír = to hear
el parque = park
el partido = game; match
el pasatiempo = pastime; hobby
pasear = to take a walk
pasear en bicicleta = to ride a bicycle
patinar (en línea) = to (inline) skate
pedir (e:i) = to ask for; to request
la pelota = ball
pensar (e:ie) = to think
pensar en = to think about
perder (e:ie) = to lose; to miss
la piscina = swimming pool
la plaza = city or town square
poder (o:ue) = to be able to; can
poner = to put; to place
practicar deportes (m., pl.) = to play sports
preferir (e:ie) = to prefer
querer (e:ie) = to want; to love
los ratos libres = spare (free) time
recordar (o:ue) = to remember
repetir (e:i) = to repeat
el restaurante = restaurant
salir = to leave
seguir (e:i) = to follow; to continue
suponer = to suppose
el tenis = tennis
tomar el sol = to sunbathe
traer = to bring
ver = to see
ver películas (f., pl.) = to watch movies
el videojuego = video game
visitar monumentos (m., pl.) = to visit monuments
el vóleibol = volleyball
volver (o:ue) = to return 
