el béisbol = baseball
el ciclismo = cycling
el esqui (acuático) = (water) skiing
el fútbol americano = football
el golf = golf
el hockey = hockey
la natación = swimming
el tenis = tennis
el vóleibol = volleyball
el equipo = team
el parque = park
el partido = game, match
la plaza = city or town square
andar en patineta = to skateboard
bucear = to scuba dive
esalalar montañas = to climb mountains
esquiar = to ski
ganar = to win
ir de excursión = to go on a hike
practicar deportes = to play sports
escribir una carta = to write a letter
un mensaje electrónico = to write an e-mail
leer correo electrónico = to read e-mail
leer una revista = to read a magazine
deportivo/a = sports-related
la jugadora = player (fem)
el jugador = player (mas)
tomar el sol = to sunbathe
leer el periódico = to read the newspaper
la pelota = ball
el fútbol = soccer
el fútbol americano = football 
visitar el monumento = to visit the monument
nadar = to swim
la piscina = swimming pool
pasear = to take a walk, to stroll
pasear en bicicleta = to ride a bicycle
ganar = to win
el baloncesto = basketball
la diversión = fun activity, entertainment, recreation
el fin de semana = weekend
el pasatiempo = passtime, hobby
los ratos libres = spare time
el videojuego = video game
la iglesia = church
el lugar = place
ver películas = to watch movies
favorito/a = favorite
patinar (en linea) = to (inline) skate
practicar deportes = to play sports
el café = cafe
el centro = downtown
el cine = movie theater
el gimnasio = gymnasium
la iglesia = church
el museo = museum
almorzar (o:ue) = to have lunch
cerrar (e:ie) = to close
comenzar (e:ie) = to begin
conseguir (e:i) = to get; to obtain
contar (o:ue) = to count; to tell
empezar (e:ie) = to begin
pensar (e:ie) = to think
entendar (e:ie) = to understand
preferir (e:ie) = to prefer
querer (e:ie) = to love; to want
dormir (o:ue) = to sleep
encontrar (o:ue) = to find
mostrar (o:ue) = to show
poder (o:ue) = to be able to; can
recordar (o:ue) = to remember
volver (o:ue) = to return
jugar (u:ue) = to play a sport or a game
pedir (e:i) = to ask for; to request
decir (e:i) = to say; to tell
repetir (e:i) = to repeat
seguir (e:i) = to follow; to continue; to keep (doing something)
hacer = to do; to make
poner = to put; to place
salir = to leave
suponer = to suppose
traer = to bring
ver = to see
oir = to hear
